%%%%%%%%%%%%%%%%%%%%%%%%%%%%%%%%%%%%
%         P                        %
%          %%%%%%%%%%%%%%%%%%%%%%%%%
%..........                        %
%%%%%%%%%%%%%%%%%%%%%%%%%%%%%%%%%%%%